year,Explosions/Remote violence,Protests,Riots,Strategic developments,Violence against civilians,Total
2009,0,3,3,0,8,14
2010,0,10,1,0,8,19
2011,0,8,1,0,6,15
2012,0,16,2,0,19,37
2013,0,32,0,0,18,50
2014,1,58,18,0,19,96
2015,0,46,7,0,18,71
2016,0,43,6,0,19,68
2017,1,26,5,1,26,59
2018,0,50,10,0,51,111
2019,0,109,15,4,108,236
2020,0,176,35,5,201,417
2021,0,134,39,9,263,445
2022,2,111,38,19,347,517
