year,Explosions/Remote violence,Protests,Riots,Strategic developments,Violence against civilians,Total
2009,0,157,0,0,3,160
2010,0,0,1,0,16,17
2011,0,11,0,0,1,12
2012,0,0,3,0,35,38
2013,0,0,0,0,17,17
2014,6,1,3,0,57,67
2015,0,0,1,0,42,43
2016,0,0,2,0,38,40
2017,3,0,0,0,20,23
2018,0,0,2,0,35,37
2019,0,0,2,0,83,85
2020,0,0,14,0,67,81
2021,0,1,9,0,214,224
2022,5,2,13,0,305,325
